.───.──.───.
..──..─.....
............
............
............
............
............
............
............
............
............
............
............

─ │ ┌ ┐ ┘ ├ └ ┤ ┬ ┴ ┼ ▫ ■